架式	架势
车把势	车把式
驾御	驾驭
恢弘	恢宏
恍忽	恍惚
花把势	花把式
花消	花销
宏扬	弘扬
红通通	红彤彤
合子	盒子
黑呼呼	黑乎乎
黑忽忽	黑乎乎
黑糊糊	黑乎乎
好高务远	好高骛远
好象	好像
趁心	称心
喝采	喝彩
成份	成分
该博	赅博
恭惟	恭维
霭然	蔼然
轨范	规范
安祥	安详
班驳	斑驳
辈份	辈分
敝履	敝屣
辨驳	辩驳
表像	表象
部份	部分
刺猥	刺猬
凑乎	凑合
粗旷	粗犷
粗砺	粗粝
措词	措辞
答覆	答复
打浑	打诨
渡假	度假
而己	而已
发楞	发愣
分脏	分赃
福份	福分
高梁	高粱
鬼崇	鬼祟
过份	过分
寒喧	寒暄
怀妊	怀孕
机率=几率
己经	已经
记要	纪要
既便	即便
交待	交代
叫化子	叫花子
叫作	叫做
介面	界面
斤头	筋斗
炯然	迥然
决窍	诀窍
肯切	垦切
暌暌	睽睽
睽隔	暌隔
睽违	暌违
蜡板	蜡版
蜡梅	腊梅
流览	浏览
轮廊	轮廓
落莫	落寞
落坐	落座
脉膊	脉搏
迷团	谜团
迷眼	眯眼
糜费	靡费
明辩	明辨
乓赛	乒赛
旁鹜	旁骛
配戴	佩戴
迁徒	迁徙
情份	情分
请贴	请帖
热呼呼	热乎乎
扫瞄	扫描
神密	神秘
撕打	厮打
撕扭	厮扭
撕杀	厮杀
伺候	侍候
伺侯	侍候
伺弄	侍弄
松驰	松弛
搜购	收购
搜括	搜刮
贪脏	贪赃
挺刮	挺括
通辑	通缉
妥帖	妥贴
婉惜	惋惜
喜贴	喜帖
遐尔	遐迩
暇疵	瑕疵
象样	像样
陷井	陷阱
亵读	亵渎
厌足	餍足
央及	殃及
要决	要诀
夜消	夜宵
优愁	忧愁
争辨	争辩
知已	知己
字贴	字帖
作崇	作祟
辨证法	辩证法
拨郎鼓	拨浪鼓
波浪鼓	拨浪鼓
波罗蜜	菠萝蜜
陈旧性	呈旧性
高梁米	高粱米
姣姣者	佼佼者
癞哈蟆	癞蛤蟆
林阴道	林荫道
祝酒词	祝酒辞
综合症	综合征
按步就班	按部就班
白壁无瑕	白璧无瑕
插科打浑	插科打诨
反唇相稽	反唇相讥
服服贴贴	服服帖帖
俯拾皆是	俯拾即是
俯首贴耳	俯首帖耳
嘎然而止	戛然而止
攻城掠地	攻城略地
黑古隆冬	黑咕隆咚
虎视耽耽	虎视眈眈
坚苦卓绝	艰苦卓绝
伶牙利齿	伶牙俐齿
毛骨耸然	毛骨悚然
山青水秀	山清水秀
水性扬花	水性杨花
甜言密语	甜言蜜语
兴高彩烈	兴高采烈
虚无缥渺	虚无缥缈
知已知彼	知己知彼
直接了当	直截了当
自始自终	自始至终
走头无路	走投无路
敞蓬车	敞篷车
—般	一般
共渡	共度			
挂勾	挂钩
宏亮	洪亮					
家俱	家具
混和	混合					
幅射	辐射		
租凭	租赁
股分	股份
关健	关键
剌激	刺激
复盖	覆盖
配带	佩带
